NO ./textures/207.png
SO ./textures/214.png
WE ./textures/215.png
EA ./textures/216.png

F 33,33,33
C 0,16,64

11111111111111111111
10000000100000100001
10111010101101010101
10001000101000101001
10101010101111101011
10001010000000101001
11101010111110101011
10000010000010000001
10111110101011111101
10000010001000000001
10111010101010101101
10001010001010101001
10101011111010101011
10001000000010100N01
11111111111111111111