NO ./src/texture/207.png
SO ./src/texture/214.png
WE ./src/texture/215.png
EA ./src/texture/216.png

F 33,33,33
C 0,16,64

111111
100S01
100001
100011
111111