NO ./src/texture/207.png
SO ./src/texture/214.png
WE ./src/texture/215.png
EA ./src/texture/216.png

F 33,33,33
C 0,16,64

11111
10001
10S01
10101
11111
