NO ./textures/207.png
SO ./textures/214.png
WE ./textures/215.png
EA ./textures/216.png

F 33,33,33
C 0,16,64

                             111111111111
                             100000000001
11111111111111111111111111   100000000001
10000000000000000000000001111100111111001
10001010101000000000000000000000000001001
10000000000000000000000000000000000001001
10001000001000000000000001000000000001001
100000000000000000000000011111111111110011
100010000010000000000000000000000000000001
111111111111111111111111111111111111111111

111111111111111111111111111111111111111111
100000000000000000000000000000000000000001
100010101010000000000000011111111111110011
10000000000000000000N00001000000000001001
11100111111111111111111111000000000001001
  1001                   1000000000001001
  1001111111111111111111111111001111110011
  1000000000000000000000000000000000000001
  1000000000000000000000000000000000000001
  1111111111111111111111111111111111111111