111111
100101
101N01
1100N1
111111