
NO ./textures/amogus.png
SO ./textures/amogus.png
WE ./textures/amogus.png
EA ./textures/amogus.png

F 220,100,0
C 225,30,0

11111111111
10000001001
11E00000011
10000000001
11111111111
