
NO ./textur   es/    amogus.png

C 225,     30        ,   0
dfghjk
SO ./tex   tur   es/    amogus.p   ng
WE ./tex tur e    s/amog us. png

EA ./       tex t ure s/amogu s.png


MAIS NAN
F                  220,    100,   0



11111111111
10000001001
11E00000011
10000000001
11111111111