NO ./textures/n.png
SO ./textures/s.png
WE ./textures/w.png
EA ./textures/e.png

F 220,000,0
C 225,30,100

11111111111
10000001001
1100000E011
10000000001
11111111111
