
NO ./textures/testexture.png
SO ./textures/testexture.png
WE ./textures/testexture.png
EA ./textures/testexture.png

F 220,100,0
C 225,30,0

11111111111
1N000001001
11000000011
10000000001
11111111111
